R 600 400
NO ./textures/north.xpm
SO ./textures/south.xpm
WE ./textures/west.xpm
EA ./textures/east.xpm

S ./textures/sprites.xpm
C 146, 161, 207
F 45, 74, 26

        1111111111111111111111111
        1000000000110000000000001
        1011000001110000000002001
        1001000000000000000000001
111111111011000001110000000000001
1000000000110000011101111101111111
11110111111111011100000010001
11110111111111011101010010001
10000000110101011100020010001
10002000000000001100000010001
10000000000000001101010010001
01000001110101011111011110N01111111111
11110111 1110101 101111010001
11111111 1111111 11111111111100